{
  "id": "level-1",
  "name": "First Spark",
  "config": {
    "gridSize": 16,
    "timersAllowed": false,
    "blastRange": 3,
    "maxActiveBombs": 4,
    "maxBombsPerTurn": 1,
    "defaultHearingRadius": 6,
    "memoryTTL": 8,
    "chainReactions": false
  },
  "guards": [
    {
      "x": 8,
      "y": 5,
      "hearingRadius": 6
    }
  ],
  "targets": [
    {
      "x": 11,
      "y": 5
    }
  ],
  "grid": [
    [2, 2, 2, 2, 2, 2, 2, 2, 2, 2, 2, 2, 2, 2, 2, 2],
    [2, 2, 2, 2, 2, 2, 2, 2, 2, 2, 2, 2, 2, 2, 2, 2],
    [2, 2, 1, 1, 1, 1, 1, 1, 1, 1, 1, 1, 1, 1, 2, 2],
    [2, 2, 1, 0, 0, 0, 0, 0, 0, 0, 0, 0, 0, 1, 2, 2],
    [2, 2, 1, 0, 0, 0, 0, 1, 0, 0, 0, 0, 0, 1, 2, 2],
    [2, 2, 1, 0, 0, 0, 0, 1, 0, 0, 0, 0, 0, 1, 2, 2],
    [2, 2, 1, 0, 0, 0, 0, 1, 0, 0, 0, 0, 0, 1, 2, 2],
    [2, 2, 1, 0, 0, 0, 0, 0, 0, 0, 0, 0, 0, 1, 2, 2],
    [2, 2, 1, 1, 1, 1, 1, 1, 1, 1, 1, 1, 1, 1, 2, 2],
    [2, 2, 2, 2, 2, 2, 2, 2, 2, 2, 2, 2, 2, 2, 2, 2],
    [2, 2, 2, 2, 2, 2, 2, 2, 2, 2, 2, 2, 2, 2, 2, 2],
    [2, 2, 2, 2, 2, 2, 2, 2, 2, 2, 2, 2, 2, 2, 2, 2],
    [2, 2, 2, 2, 2, 2, 2, 2, 2, 2, 2, 2, 2, 2, 2, 2],
    [2, 2, 2, 2, 2, 2, 2, 2, 2, 2, 2, 2, 2, 2, 2, 2],
    [2, 2, 2, 2, 2, 2, 2, 2, 2, 2, 2, 2, 2, 2, 2, 2],
    [2, 2, 2, 2, 2, 2, 2, 2, 2, 2, 2, 2, 2, 2, 2, 2]
  ]
}

