{
  "id": "level-3",
  "name": "Countdown",
  "config": {
    "gridSize": 16,
    "timersAllowed": true,
    "blastRange": 3,
    "maxActiveBombs": 4,
    "maxBombsPerTurn": 1,
    "defaultHearingRadius": 6,
    "memoryTTL": 8,
    "chainReactions": false
  },
  "guards": [
    {
      "x": 12,
      "y": 6,
      "hearingRadius": 6
    }
  ],
  "targets": [
    {
      "x": 12,
      "y": 5
    }
  ],
  "grid": [
    [2, 2, 2, 2, 2, 2, 2, 2, 2, 2, 2, 2, 2, 2, 2, 2],
    [2, 2, 2, 2, 2, 2, 2, 2, 2, 2, 2, 2, 2, 2, 2, 2],
    [2, 2, 1, 1, 1, 1, 1, 1, 1, 1, 1, 1, 1, 1, 2, 2],
    [2, 2, 1, 0, 0, 0, 0, 0, 0, 0, 0, 0, 0, 1, 2, 2],
    [2, 2, 1, 0, 0, 0, 0, 1, 1, 1, 1, 1, 0, 1, 2, 2],
    [2, 2, 1, 0, 0, 0, 0, 1, 0, 0, 0, 1, 0, 1, 2, 2],
    [2, 2, 1, 0, 0, 0, 0, 1, 0, 0, 0, 1, 0, 1, 2, 2],
    [2, 2, 1, 0, 0, 0, 0, 0, 0, 0, 0, 1, 0, 1, 2, 2],
    [2, 2, 1, 1, 1, 1, 1, 1, 1, 1, 1, 1, 1, 1, 2, 2],
    [2, 2, 2, 2, 2, 2, 2, 2, 2, 2, 2, 2, 2, 2, 2, 2],
    [2, 2, 2, 2, 2, 2, 2, 2, 2, 2, 2, 2, 2, 2, 2, 2],
    [2, 2, 2, 2, 2, 2, 2, 2, 2, 2, 2, 2, 2, 2, 2, 2],
    [2, 2, 2, 2, 2, 2, 2, 2, 2, 2, 2, 2, 2, 2, 2, 2],
    [2, 2, 2, 2, 2, 2, 2, 2, 2, 2, 2, 2, 2, 2, 2, 2],
    [2, 2, 2, 2, 2, 2, 2, 2, 2, 2, 2, 2, 2, 2, 2, 2],
    [2, 2, 2, 2, 2, 2, 2, 2, 2, 2, 2, 2, 2, 2, 2, 2]
  ]
}
